DDDDDDDDDD
DXXXXXDXXD
DXDDDDDDXD
DXDDDDDDXD
DXDXXXXXXD
DXDXDDDDXD
DXDXDDDDXD
DXDDDDDDXD
DXXXXXXXXD
DDDDDDDDDD