DDDDDDDDDDDDDDDXXXXXD
DXXXXXDXXDDDDXXXDDDDD
DXDDDDDDXDDDDDDDDXXXD
DXDDDDDDXDXXXXXXDDDDD
DXDXXXXXXDXXXXDXXXXXD
DXDXDDDDXDDDDDDXXXXXD
DXDXDDDDXDXXXXXDXXXXD
DXDDDDDDXDDDDXXDDXXXD
DXXXXXXXXDDDDXXDXXXXD
DDDDDDDDDDXXXXXDDDDDD