DDDDDDDDDDDDDDDDDDDDDDDDDDDDDDDDDDDDDDDDDDDD
DXXXXXXXXXXXXXXXXXXXXXXXXXXXXXDXXXXXXXXXXXDD
DXDDDDDDDDDDDDDDDDDDDDDDDDDDDXDXDDDDDDDXDXDD
DXDDDDDDDDDDDDDDDDDDDDDDDDDDDXDXDDDDDDDXDXDX
DXDDDDDDDDDDDDDDDDDDDDDDDDDDDXDDDXXXXXDXDXDX
DXDDDDDDDDDDDDDDDDDDDDDDDDDDDXXXDXXXXXDDDXDX
DXDDDDDDDDDDDDDDDDDDDDDDDDDDDDDDDDDXDDDDDXDX
DXDDDDDDDDDDDDDDDDDDDDDDDDDDDDDDDDDXDDDDDXDX
DXDDDDDDDDDDDDDDDDDDDDDDDDDDDDDDDDDXDDDDDXDX
DXDDDDDDDDDDDDDDDDDDDDDDDDDDDDDDDDDXDDDDDXDX
DXDDDDDDDDDDDDDDXXXXXDXDDDDDDDDDDDDXDDDDDXDX
DXDDDDDDDDDDDDDDXDDDDDXDDDDDDDDDDDDXDDDDDXDX
DXDDDDDDDDDDDDDDXXXXXXDDDDDDDDDDDDDXDDDDDXDX
DXDDDDDDDDDDDDDDDDDDDDDDDDDDDDDDDDDXDDDDDXDX
DXDDDDDDDDDDDDDDDDDDDDDDDDDDDDDDDDDXDDDDDXDX
DXDDDDDDDDDDDDDDDDDDDDDDDDDDDDDDDDDXDDDDDXDX
DXDDDDDDDDDDDDDDDDDDDDDDDDDDDDDDDDDXDDDDDXDX
DXDDDDDDDDDDDDDDDDDDDDDDDDDDDDDDDDDXDDDDDXDX
DXXXXXXXXXXXXXXXXXXXXXXXXXXXXXXXXXXXXXXXXXDX
DDDDDDDDDDDDDDDDDDDDDDDDDDDDDDDDDDDDDDDDDDDD